140 SUPPLEMENTARY NOTES.

oppressit: surprised.

50. acutis: aa. those which require acateaess of intellect.

docuisset: the managei taught the play to the actors; translate, had
broupht out oc the stopo.

processit aetate : lived oc ,· cf. aetate processisset, VII. 21.

loquar: deliberative subjunctive. ’

senes: having the force oi a temporal clause.

exerceri: reflexive in iorce.

comparandae: cac be compared. The gerundive in a negative sentence,
or in a question suggesting a negative answm, has the force of possibility.

illud: that well-tracum

ante dixi: in VIII. 26.

XV. 51. Habent. . . rationem: the subiect refers to agricolarum.
habere rationem is a cornmercial expression, to hace aa account with.

recusat imperium: ci. Tac. Germ. 26, sota terrae sepes imperatur.

plerumque: stands in place ci a second alias.

Quamquam: see on I. l.

vis ac natura: hendiadys; tlte nataralsorce.

Quae: see on qui, Ι. 3.

gremio: note the omission oi the prepositicn. The word is used figu-
ratively, “ in the lap ci mother earth.”

occaecatum: liddon from tlte tiata.

occatio : harrowicp. This is not connected with occaecatum ; but comes
from occare, root AC.

tepefactum: accusative; sc. semen.

vapore: beat.

diffundit: it causes the seed to eapaad.

viriditatem: career: shcot ,· abstract for concrete.

iibrIs stirpium: fibers os the roots.
' culmi) . . . geniculato: oc its joiuted static.

vaginis: translate in the singular, asceaco.

quasi pubescens: as if maturina

spici: from spicum ,· limiting ordine. *

52. commemorem: see on loquar, XIV. 50.

ut. . . noscatis: there is an ellipsis ol the governing clause, “I say
thie,'' ilict. See on ae . . . videar, XIV. 46.

omnium quae . . . eterra: the Latin has no one substantive which can
be used in this comprehensive sense. - Meissner.

tantulis: note the iorce oi the diminutive and the omission oi its correl-
ativeterm.

 

